// from www.statoids.com/umx.html

AGS  : AGS, AGUASCALIENTES, AGAS
BC   : BC, BAJA CALIFORNIA, BAJA CALIFORNIA NORTE, B C, BN, B N, BCN, B C N
BCS  : BCS, BAJA CALIFORNIA SUR, B C S
CAM  : CAM, CAMPECHE
CHIS : CHIS, CHIAPAS
CHIH : CHIH, CHIHUAHUA
COAH : COAH, COAHUILA, CHL // I added this last one...it may be wrong
COL  : COL, COLIMA
DF   : DF, DIF, DISTRITO FEDERAL, D F, FEDERAL DISTRICT, EDO DE MEXICO, EDEFICIO MEXICO, EDO MEX // I think this last one is right...
DGO  : DGO, DURANGO
GTO  : GTO, GUANAJUATO
GRO  : GRO, GUERRERO
HGO  : HGO, HIDALGO
JAL  : JAL, JALISCO
MEX  : MEX, MEXICO
MICH : MI, MICH, MICHOACAN // NOTE: potential collisions with Michigan...
MOR  : MOR, MORELOS
NAY  : NAY, NAYARIT
NL   : NL, NUEVO LEON, N L
OAX  : OAX, OAXACA
PUE  : PUE, PUEBLA
QRO  : QRO, QUERETARO
QROO : QROO, QUINTANA ROO
SLP  : SLP, SAN LUIS POTOSI
SIN  : SIN, SINALOA
SON  : SON, SONORA
TAB  : TAB, TABASCO
TAMPS : TAMPS, TAMAULIPAS
TLAX : TLAX, TLAXCALA
VER  : VER, VERACRUZ, VERA
YUC  : YUC, YUCATAN
ZAC  : ZAC, ZACTS, ZACATECAS