AD : ANDORRA
AE : UNITED ARAB EMIRATES
AF : AFGHANISTAN
AG : ANTIGUA AND BARBUDA
AI : ANGUILLA
AL : ALBANIA
AM : ARMENIA
AN : NETHERLAND ANTILLES
AO : ANGOLA
AQ : ANTARCTICA
AR : ARGENTINA, ARG
AS : AMERICAN SAMOA
AT : AUSTRIA, OESTERREICH
AU : AUSTRALIA
AW : ARUBA
AZ : AZERBAIDJAN, AZERBAIJAN

BA : BOSNIA HERZEGOVINA
BB : BARBADOS
BD : BANGLADESH
BE : BELGIUM, BELGIQUE, BELGIE, BELG
BF : BURKINA FASO
BG : BULGARIA
BH : BAHRAIN
BI : BURUNDI
BJ : BENIN
BM : BERMUDA
BN : BRUNEI DARUSSALAM
BO : BOLIVIA
BR : BRAZIL, BRASIL
BS : BAHAMAS
BT : BUTHAN
BV : BOUVET ISLAND
BW : BOTSWANA
BY : BELARUS
BZ : BELIZE

CA : CANADA
CC : COCOS ISLANDS, KEELING ISLANDS
CF : CENTRAL AFRICAN REPUBLIC
CG : CONGO
CH : SWITZERLAND, SUISSE, SCHWEIZ, SVIZZERA, SWISS CONFEDERATION, SWTZ, SWITZ
CI : IVORY COAST
CK : COOK ISLANDS
CL : CHILE
CM : CAMEROON
CN : CHINA
CO : COLOMBIA, COLUMBIA
CR : COSTA RICA
CS : CZECHOSLOVAKIA
CU : CUBA
CV : CAPE VERDE
CX : CHRISTMAS ISLAND
CY : CYPRUS
CZ : CZECH REPUBLIC

DE : GERMANY, GE, GER, EAST GERMANY, WEST GERMANY, DEUTSCHLAND, FEDERAL REPUBLIC OF GERMANY, FED REP OF GERMANY, DDR, GERMANY DDR, GERMAN DEMOCRATIC REPUBLIC, DEMOCRATIC REPUBLIC OF GERMANY, DEMOCRATIC REPUB OF GERMANY, DEMOCRATIC REP OF GERMANY
DJ : DJIBOUTI
DK : DENMARK, DANMARK
DM : DOMINICA
DO : DOMINICAN REPUBLIC, REPUBLICA DOMINICANA, REP DOM, REP DOMINICANA
DZ : ALGERIA

EC : ECUADOR
EE : ESTONIA
EG : EGYPT
EH : WESTERN SAHARA
ES : SPAIN, ESPANA, SPANIEN, ESPAANA
ET : ETHIOPIA

FI : FINLAND, SUOMI // in Finnish
FJ : FIJI
FK : FALKLAND ISLANDS, MALVINAS
FM : MICRONESIA, FEDERATED STATES OF MICRONESIA
FO : FAROE ISLANDS
FR : FRANCE, FRANCIA, FRANKREICH
// FX : FRANCE (EUROPEAN TER.)

GA : GABON
//GB : GB, GREAT BRITAIN, GBR, G B, UNITED KINGDOM, UK, U K, WALES, NORTHERN IRELAND, SCOTLAND, ENGLAND, BRITISH ISLES, ENG
GD : GRENADA
GE : GEORGIA
GH : GHANA
GI : GIBRALTAR
GL : GREENLAND
GP : GUADELOUPE
GQ : EQUATORIAL GUINEA
GF : FRENCH GUYANA, GUYANA (FRENCH)
GM : GAMBIA
GN : GUINEA
GR : GREECE
GT : GUATEMALA, GUATE, GUATEMAL
GU : GUAM (US), GUAM
GW : GUINEA BISSAU
GY : GUYANA

HK : HONG KONG
HM : HEARD AND MCDONALD ISLANDS
HN : HONDURAS
HR : CROATIA
HT : HAITI
HU : HUNGARY

ID : INDONESIA, INA
IE : IRELAND, REPUBLIC OF IRELAND, ROI, EIRE
IL : ISRAEL
IN : INDIA
//IO : BRITISH INDIAN O. TERR.
IQ : IRAQ
IR : IRAN
IS : ICELAND
IT : ITALY, ITALIA, ITALIEN

JM : JAMAICA
JO : JORDAN
JP : JAPAN

KE : KENYA
KG : KIRGISTAN, KYRGYZSTAN
KH : CAMBODIA
KI : KIRIBATI
KM : COMOROS
KN : ST KITTS NEVIS ANGUILLA
KP : KOREA NORTH, NORTH KOREA, NORTH COREA
KR : KOREA SOUTH, SOUTH KOREA, SOUTH COREA
KW : KUWAIT
KY : CAYMAN ISLANDS
KZ : KAZACHSTAN, KAZAKHSTAN

LA : LAOS
LB : LEBANON
LC : SAINT LUCIA
LI : LIECHTENSTEIN
LK : SRI LANKA
LR : LIBERIA
LS : LESOTHO
LT : LITHUANIA
LU : LUXEMBOURG
LV : LATVIA
LY : LIBYA, LIBYAN ARAB JAMAHIRIYA

MA : MOROCCO
MC : MONACO
MD : MOLDAVIA, MOLDOVA
MG : MADAGASCAR
MH : MARSHALL ISLANDS
ML : MALI
MM : MYANMAR
MN : MONGOLIA
MO : MACAU
MP : NORTHERN MARIANA ISLANDS
MQ : MARTINIQUE
MR : MAURITANIA
MS : MONTSERRAT
MT : MALTA
MU : MAURITIUS
MV : MALDIVES
MW : MALAWI
MX : MEXICO, MEX, MXICO
MY : MALAYSIA
MZ : MOZAMBIQUE

NA : NAMIBIA
NC : NEW CALEDONIA
NE : NIGER
NF : NORFOLK ISLAND
NG : NIGERIA
NI : NICARAGUA
NL : NETHERLANDS, THE NETHERLANDS, NEDERLAND, NETHERLAND, NIEDERLANDE, NIEDERLAND, HOLLAND
NO : NORWAY, NORGE
NP : NEPAL
NR : NAURU
NT : NEUTRAL ZONE
NU : NIUE
NZ : NEW ZEALAND

OM : OMAN

PA : PANAMA
PE : PERU
PF : POLYNESIA, FRENCH POLYNESIA, POLYNESIE FRANCAISE, POLYNESIE FANCAISE // TODO: remove this last one, and handle with edit distance...
PG : PAPUA NEW GUINEA
PH : PHILIPPINES, PHILS
PK : PAKISTAN
PL : POLAND, POLSKA
PM : ST. PIERRE & MIQUELON
PN : PITCAIRN
PT : PORTUGAL
PR : PUERTO RICO
PW : PALAU
PY : PARAGUAY

QA : QATAR

RE : REUNION, REUNION ISLAND
RO : ROMANIA
RU : RUSSIAN FEDERATION, RUSSIA
RW : RWANDA

SA : SAUDI ARABIA
SB : SOLOMON ISLANDS
SC : SEYCHELLES
SD : SUDAN
SE : SWEDEN, SVERIGE // in Swedish
SG : SINGAPORE
SH : ST HELENA
SI : SLOVENIA
SJ : SVALBARD AND JAN MAYEN ISLANDS
SK : SLOVAK REPUBLIC, SLOVAKIA, SLOVAKIA (SLOVAK REPUBLIC)
SL : SIERRA LEONE
SM : SAN MARINO
SN : SENEGAL
SO : SOMALIA
SR : SURINAME
ST : ST TOME AND PRINCIPE, SAO TOME AND RINCIPE
// SU : SOVIET UNION
SV : EL SALVADOR
SY : SYRIA, SYRIAN ARAB REPUBLIC
SZ : SWAZILAND

TC : TURKS AND CAICOS ISLANDS
TD : CHAD
//TF : FRENCH SOUTHERN TERR.
TG : TOGO
TH : THAILAND
TJ : TADJIKISTAN, TAJIKISTAN
TK : TOKELAU
TM : TURKMENISTAN
TN : TUNISIA
TO : TONGA
TP : EAST TIMOR
TR : TURKEY
TT : TRINIDAD AND TOBAGO, TRINIDAD, TAT
TV : TUVALU
TW : TAIWAN, TAIPEI, TAIWAN PROVINCE OF CHINA
TZ : TANZANIA

UA : UKRAINE
UG : UGANDA
UK : GB, GREAT BRITAIN, GBR, G B, UNITED KINGDOM, UK, U K, WALES, NORTHERN IRELAND, N IRELAND, SCOTLAND, ENGLAND, BRITISH ISLES, ENG, ISLE OF WIGHT, ISLE OF MAN
UM : US MINOR OUTLYING ISL.
US : US, UNITED STATES, UNITED STATES OF AMERICA, USA, U S, U S A, EEUU, AMERICA
UY : UY, URUGUAY
UZ : UZBEKISTAN

VA : VATICAN CITY STATE
VC : ST VINCENT AND THE GRENADINES, ST VINCENT, GRENADINES
VE : VENEZUELA, VZLA
VG : VIRGIN ISLANDS (BRITISH), BRITISH VIRGIN ISLANDS, BVI
VI : VIRGIN ISLANDS (US), US VIRGIN ISLANDS, USVI
VN : VIETNAM
VU : VANUATU

WF : WALLIS AND FUTUNA ISLANDS
WS : SAMOA, WESTERN SAMOA

YE : YEMEN
YU : YUGOSLAVIA

ZA : SOUTH AFRICA, SO AFRICA, SO AFR
ZM : ZAMBIA
ZR : ZAIRE
ZW : ZIMBABWE


